
R 1000 1000

NO  ./textures/wood.xpm
SO ./textures/wood.xpm
WE ./textures/wood.xpm
EA ./textures/wood.xpm



S ./textures/pillar.xpm 

F 255,255,0
C 0,0,128


1111111111111111111111111
1001    100110000000000001
1011    111000000200000111
10011111102000000000000000111111111
1111111110110000011100000000000021
100000000111100001  11011111111111
1111111111111111111111111111111
 
11111111111111111111111111111
111011111    1111011100000011
111101111     1111101110121001
1100000011     101001110000001
100020000011111111000000001111
1000000002220000000N00000021
1100000111010101111112002001111
11110111 1110101 1011110121001
11111111 1111111 111111111111